30
#########
#  #    #
#  #  G #
#  #    #
#  #    #
#       #
#  S    #
#########
